111111111
110CPEZ11
111111111
