1111111111
1000E00C11
1000000111
10P0C00C11
1111111111
1C00C00C01
1111111111
