1111111111
1010E00C11
1000100111
10PZC00C11
1111111111
1C00C00C01
1111111111
