1111111111
1E10000C11
1110000111
10P0C00C11
1111111111
1C00C00C01
1111111111
