1111111111
1E00000C11
1000000111
10PPC00C11
1000000001
1C00C00C01
1111111111
