1111111111
1E10000C11
1000000111
10P0C00C11
1000000001
1C00CE0C01
1111111111
