1111111111
1P10000C11
1110000111
10E0C00C11
1111111111
1C00C00C01
1111111111
