1111111111
1E10000011
1000000110
10P0000011
1000000001
1000000001
1111111111
