1111111111
1010000C11
1000000110
10P0C00C11
1000000001
1C00C00C01
1111111111
