111111111111111111111111111111111111111111111
1E00C0P0000000000000000000000000000000C000001
111111111111111111111111111111111111111111111
