111111111111111
111P00001110C01
11000C011111001
10000001111C001
100C00000000001
100000C00000111
1E0000000011111
111111111111111
