11111111111111111
101E00C1111P00001
1C100001C11110001
10000000000000001
11111000000111111
1C00C00C000000C01
10000000000000001
1CC00000000000001
101000C1111000001
1C100001C11110001
10000000000000001
10000111111111111
1C00C00C000000C01
11111111111111111
